i-8xqJayfvEitByc8BRmNsQU	Följande skrivelser hade kommit in:
i-8qhLwyRrxKuSoTUikJQM6	Interpellationen kommer att besvaras torsdagen den 14 januari 2021.
i-Hi2UCYdobJ9yNDBtu3mwZo	Skälet till dröjsmålet är sjukdom.
i-pmHfNNBAVcs83TJiFMCFz	Interpellationen kommer att besvaras torsdagen den 14 januari 2021.
i-mEqv4e3uNmxf4njTbgirq	Skälet till dröjsmålet är sjukdom.
i-GMJE5QCP2iWqZ1higBT6xE	Interpellationen kommer att besvaras torsdagen den 14 januari 2021.
i-HMXvnsweqNw2UYuRXLV8YP	Skälet till dröjsmålet är sjukdom.
i-1newshHDaGnZsEr4tixmH	Interpellationen har överlämnats till sr Ygeman och kommer att besvaras torsdagen den 14 januari 2021 .
i-XNsimaTYMjcpMninhqxZPr	Skälet till dröjsmålet är sjukdom.
i-7cn9NmVA8KvmN3ctzNoDd3	Interpellationen kommer att besvaras torsdagen den 14 januari 2021.
i-66mVMt2DezsYQKPryrUYbd	Skälet till dröjsmålet är sjukdom.
i-LvuB5pSSDo8aoBArgaJRTc	Interpellationen kommer att besvaras tisdagen den 19 januari 2021.
i-RNsQM5C6vkjbAcMWUGcoLk	Statsrådet har inte möjlighet att besvara interpellationen inom anvisad tid på grund av redan inbokade engagemang.
i-7TZtLyVXEmvRCscsSQx1Rk	Statsrådet har inte möjlighet att besvara interpellationen inom anvisad tid på grund av redan inbokade engagemang.
i-3wxAsdTp4s7JpD7HJn3TJP	Interpellationen kommer att besvaras fredagen den 22 januari 2021.
i-g54xM6BEULHWLnQrL2ZAN	Skälet till dröjsmålet är sedan tidigare inbokade engagemang.
i-RYBmzqyKxALnY3bvJLjPdW	Interpellationen kommer inte hinna besvaras inom tidsfristen.
i-C1tegs5oVTZbqs7nqXbPLf	Skälet till dröjsmålet är tjänsteresor och andra sedan tidigare inbokade arrangemang.
i-JurKiJMtRW1QCVikkgTZfR	Interpellationen kommer att besvaras den 4 februari.
i-YPwDE8WeM8GjDnJnLrekPD	Tredje vice talmannen anmäl de att följande faktapromemorior om förslag från Europeiska kommissionen hade kommit in och överlämnats till utskott:
i-3WGATf5dTBYwBPChBAmMTA	Följande dokument hänvisades till utskott:
i-NEVpBe1LPBd5WvpqCKrGS6	Åttaveckorsfristen för att avge ett motiverat yttrande skulle gå ut den 5 mars.
i-Qc5y2jA69wqYrtpsbsMWxj	Följande frågor för skriftliga svar hade framställts:
i-EAnLUc4QqRNNzNLGDkxjwP	Skriftliga svar på följande frågor hade kommit in:
