i-C1DLHzxc3baCGxeKiBz959	Enligt 6 kap. 23 § Riksdagsordningen (2014:801) får talmannen, efter samråd med gruppledarna besluta att en debatt utan samband med annan handläggning ska äga rum, en sådan debatt får begränsas till ett särskilt ämne eller delas in i avsnitt efter ämne.
i-QYvZsLZt5NypSzooxiG7rT	I samband med att Belarus genomförde allmänna val år 2020 framkom trovärdiga uppgifter om utbredda oegentligheteter i sådan omfattning att valresultatet inte kan anses spegla den Belarusiska folkviljan. Ett utbrett missnöje ledde till fredliga protester och demonstranter, aktiva inom den demokratiska oppositio ­ nen och fria journalister utsattes i samband med detta för hot, våld, trakasserier och frihetsberövanden.
i-41tjg55k9NHgcVneKNQCuM	I oktober samma år införde EU sanktioner mot regimen i Minsk som sedan dess har utökats. Per den 11 november 2021 omfattas 166 personer och 15 enheter av åtgärderna, dessa kommer dock troligtvis att utökas i närtid.
i-3y88paD5KJFCRL3EB4bxzt	Relationerna mellan EU och Belarus har sedermera försämrats. Som ett ”svar” på EU:s restriktiva åtgärder har Minsk i alla fall tillåtit, och troligtvis aktivt verkat för att landet ska bli en ny rutt för migranter som söker en väg från framför allt mellanöstern till EU. Trovärdiga uppgifter har framkommit om ”resebyråer” som tillhandahåller turistvisum i exempelvis Irak, för som vill ta sig med flyg till Minsk. Migranterna bussas sedan vidare till Belarus gräns med i första hand Polen, varefter de enligt uppgift inte tillåts återvända till Belarus.
i-54tRAstUHVHxAFS7TniA7c	Enligt uppgift ska ungefär 4000 migranter idag sitta fast vid den gränsen, samtidigt som allt fler anländer till Minsk och andra medlemsländer som gränsar till det landet rapporterar om en liknande händelseutveckling.
i-5VSgDCbvYo5bjEbsgdZbNz	Kommissionens president, Ursula von der Leyen har kallat Minsks agerande för ”en hybridattack för att destabilisera Europa”, flera höga beslutsfattare inom unionen har använt liknande uttryck.
i-TANJ66pp2c9uCgatLV19MX	En rad faktorer, både lagstiftning, rådsbeslut och policy från unionens exekutiva myndigheter kan användas för att hantera situationen. I tillägg till detta ligger ansvaret för att bevaka och skydda den yttre gränsen på medlemsstatsnivå. Krisen berör med andra ord ett brett spektrum av frågor.
i-NN2zWhA9TUFdNqBwfdFN6t	Den Sverigedemokratiska riksdagsgruppen begär därför att riksdagen håller en särskild debatt om händelseutvecklingen.
i-XD5nh9QacnM8i2QLic5LEP	Följande skrivelser hade kommit in:
i-NCS44KpijojpJBEy9uGpJQ	Interpellationen kommer att besvaras torsdagen den 16 december 2021.
i-7VNxtrT54BBb1gmm3rPg3P	Interpellationen kommer inte hinna besvaras inom tidsfristen.
i-EnekQ981DncuWA16RunGqj	Skälet till dröjsmålet är andra sedan tidigare inbokade arrangemang.
i-VpNzs6Rs4u3XBwkkdJqy37	Interpellationen kommer att besvaras den 17 december 2021.
i-Md2e4qpapC46BsQGjUEc2g	Interpellationen kommer inte hinna besvaras inom tidsfristen.
i-9Lncf5AS2iBVG8JhibLfhP	Skälet till dröjsmålet är andra sedan tidigare inbokade arrangemang.
i-EbC54CuDJSZGoqbJEGtHsd	Interpellationen kommer att besvaras den 17 december 2021.
i-JSwor5roty45KQBPZBGiGQ	Interpellationen kommer inte hinna besvaras inom tidsfristen.
i-Tg2dwXsYTMBnotmPDpGdna	Skälet till dröjsmålet är andra sedan tidigare inbokade arrangemang.
i-Y86jLgcKeE8U8yckh2PdXi	Interpellationen kommer att besvaras den 17 december 2021.
i-CYJrdEtPkc3Ci7ixE2u2Zj	Interpellationen kommer inte hinna besvaras inom tidsfristen.
i-P6nEnubJKKF1FuwYgYGojG	Skälet till dröjsmålet är andra sedan tidigare inbokade arrangemang.
i-HS9STSKBp3w6GEoJL53rZ5	Interpellationen kommer att besvaras den 17 december 2021.
i-U7L7GR6TXw7T9HBccCPyPP	Interpellationen kommer att besvaras fredagen den 17 december 2021.
i-CDP4SWQpemr9BThtcFcpn1	Skälet till dröjsmålet är sedan tidigare inbokade engagemang.
i-FFss11UPQgLdNqVtDcEGbL	Andre vice talmannen anmälde att följande faktapromemoria om förslag från Europeiska kommissionen hade kommit in och överlämnats till utskott:
i-LVDfMyPHJFH98mSvkrj2ui	Andre vice talmannen anmälde att följande granskningsrapport hade kommit in från Riksrevisionen och överlämnats till arbetsmarknadsutskottet :
i-AUDA77XHUx91KnxJ5egNSD	Följande dokument hänvisades till utskott:
i-LBn2JWAA3cmMJbHXzXnvwb	Följande frågor för skriftliga svar hade framställts:
